1111111111111111111111111111111111
1C10C100001C100000000C000000010001
1010010000101000001001000000010101
10100100001010100010010000G001C101
101G01001000G0100010G1001100011101
1010110010G00010000001001100000001
1P00000010000000C000010000000000E1
1111111111111111111111111111111111
