111111111
1000P0001
10GC00111
1C01000E1
111111111
